1,2,3,4,5
1,2,3,4,6
1,2,3,4,7
1,2,3,4,8
1,2,3,4,5
